11111111111
10000000001
100CC000001
100CC010C01
10P00011C01
10C0100CCE1
11111111111