111111111
100000E01
1P000C111
111111111