1111111111111
10010000011C1
1000011100001
1P0011E000001
1000000000001
1000000000001
1000000000001
1000000000001
1000000000001
1000000000001
1111111111111